0 0 0 0 0 0 0 0 0 0 0 0 0 0 0 2
10 0 0 0 0 0 0 0 0 0 0 0 0 0 0 2
3 0 0 0 0 3 0 0 0 0 3 0 0 0 0 2 
4 4 4 4 4 4 4 4 4 4 4 1 0 1 4 4 
2 0 0 0 0 0 0 0 0 0 0 0 0 0 0 2 
2 0 0 0 0 0 0 0 0 0 0 0 0 0 0 2 
4 4 1 0 1 4 4 4 4 4 4 4 4 4 4 4 
2 0 0 0 0 0 0 0 0 0 0 0 0 0 0 2 
2 0 0 0 0 0 0 0 0 0 0 0 0 0 0 2 
4 4 4 4 4 4 4 4 4 4 4 1 0 1 4 4 
0 9 0 0 0 0 0 0 0 0 0 0 0 0 0 2 
0 0 0 0 0 0 0 0 0 0 0 0 0 0 0 2 
4 4 4 4 4 4 4 4 4 4 4 4 4 4 4 4 