0 0 0 0 0 0 0 0 0 0 0 0 0 0 0 0
0 2 0 0 0 0 0 10 0 0 0 0 0 0 0 0
0 0 0 0 0 0 0 0 0 0 0 0 0 0 0 0 
2 0 0 4 4 4 1 1 1 1 4 4 4 0 0 0 
5 0 0 0 0 0 0 0 0 0 0 0 0 0 0 5 
2 0 0 0 0 0 0 0 0 0 0 0 0 0 0 0 
1 1 1 1 4 4 4 4 4 4 4 4 1 1 1 1 
0 0 0 0 0 0 0 0 0 0 0 0 0 0 0 0 
5 0 0 0 0 0 2 2 2 2 0 0 0 2 0 5 
1 1 1 1 0 0 0 0 0 0 0 0 1 1 1 1 
0 9 0 0 0 0 0 0 0 0 0 0 0 0 0 0 
0 0 0 0 0 0 0 0 0 0 0 0 0 2 0 3 
4 4 4 4 4 4 4 4 4 4 4 4 4 4 4 4 